Key Signatures:

* Major - Take the last sharp, and add one
	Eg 2 sharps (F# and C#) means the key is D

* Minor - The second last flat note is the name of the key
	Eg 3 flats (Bb,Eb,Ab) means the key is Eb

* Exceptions - No flats/sharps: C, 1 flat: F 1 sharp: G


Relative Major/Minor

* Major -> Rel. Minor: down by 3 semitones (C maj becomes Am)

* Minor -> Rel. Major: up by 3 semitones (Bm becomes D maj)


Clefs:

* Treble Clef: F,A,C,E in the middle of the lines

* Bass Clef: G,B,D,F,A on the lines

* Alto Clef: Middle C on the middle line


Tempo:

* Grave: Very Slow
* Adagio: Slow
* Allegretto: Moderatly Fast
* Alegro: Fast
* Presto: Very Fast

Dynamics:

* Diminuendo (dim.): Getting Quieter
* Pianissimo (pp) : Very Soft
* Piano (p) : Soft
* Mezzo Piano (mp) : Moderately Quiet
* Mezzo Forte (mf) : Moderately Loud
* Forte (f) : Loud
* Fortissimo (ff) : Very Loud
* Crescendo (cresc.): Getting Louder	



Africa - Toto (1981/82):

* Written By: David Paich and Jeff Porcaro
* Key: B major on verses, links, and instrumental. A major on Chorus
* Tempo: Moderately Fast (Allegretto)
* Dynamics: Mezzo Forte (mf) , with Forte (f) Chorus
* Instrumentation: Rock Band - Drum Kit w/ more percussion, lead + bass guitars, synths, male lead + male backing vocals
* Texture: Homophonic
* Meter: 2/2

* Verse:
	Bmaj, D#m, G#m, B/F#, A/E, E/F#, G#m, A, G#m, C#m

* Chorus:
	Short (4 bars): F#m, D, A, E (repeat)
	Long (6 bars): F#m, D, A, C#m, E, F#m, G#m, A

* Overall Structure:
	Intro, Riff 1+2, Verse 1, Chorus 1, Link 1, Verse 2, Chorus 2, Link 2, Instrumental, Chorus 3, New Riff, Outro


